Marvin	Page
Harry	Bush
Susan	Fletcher
Bill	Garcia
Victor	Harris
Marilyn	Morris
Julius	Franklin
Alma	Evans
Brandi	Wood
Blanche	Fuller
Norman	Doyle
Henrietta	Hines
Joy	Carr
Phillip	Thomas
Ann	Waters
Geneva	Sullivan
Edna	Ortega
Bradley	Hughes
Rodolfo	Freeman
Brad	Hardy
Kristy	Cobb
Tina	Pope
Lillian	Glover
Daisy	Porter
Emma	Campbell
Sandy	Day
Shannon	Hammond
Lora	Olson
Henry	Norton
Percy	Berry
Kelly	Cole
Melanie	Phelps
Terrance	Willis
Mark	Francis
Sharon	Massey
George	Moran
Adam	Reid
Todd	Woods
Betty	Ward
Mike	West
Kimberly	Tate
Angel	Nash
Lionel	Gardner
Russell	Alvarez
Matthew	Underwood
Colin	Hawkins
Johnathan	Marsh
Lamar	Howell
Peter	Lyons
Dianna	Mitchell